1111111111
1000000221
0022020221
1222020021
1022000221
1000020021
1222222001
1000000021
1022222221
1011111111
