mapSize 20 10
tileSize 64 64
mapTiles
0 0 0 0 0 0 0 0 0 0 0 0 0 0 0 0 0 0 0 0
0 1 1 1 1 1 1 1 1 0 2 2 2 0 2 2 2 2 2 0
1 1 1 1 1 1 1 1 1 0 2 1 1 0 1 1 1 1 2 0
0 1 1 1 1 2 2 2 1 0 2 1 1 0 1 1 1 1 2 0
0 1 1 1 2 2 2 2 2 2 2 1 1 0 2 2 1 1 2 0
0 1 1 1 2 2 2 2 2 0 2 1 1 0 2 2 1 1 2 0
0 1 1 1 1 2 2 2 1 0 2 1 1 0 0 0 1 0 0 0
0 1 1 1 1 1 1 1 1 0 2 1 1 1 1 1 1 1 2 0
0 1 1 1 1 1 1 1 1 0 2 2 2 2 2 2 2 2 2 0
0 0 0 0 0 0 0 0 0 0 0 0 0 0 0 0 0 0 0 0
playerSpawnPosition 0 2
enemySpawnPosition 16 3