mapSize 22 20
tileSize 128 128
mapTiles
GHHHHHHHHHHHHHHHHHHHHIH
J00000000000000000000J
JAAAAAAAAAAAAAAAAAAAAJ
JAAAAAAAAAAAAAAAAAAAAJ
JAAAAAAAAAAAAAAAAAAAAJ
JAAAAAAAAAAAAAAAAAAAAJ
OHHHHHSATHHHHIAAAAAAAJ
J000000A00000JAAAAAAAJ
JAAAAAAAAAAAAJAAAAAAAJ
JAAAAAAAAAAAAJAAAAAAAJ
JAAAAAAAAAAAAJAAAAAAAJ
JAAAAAAAAAAAAJAAAAAAAJ
JAAAAAAAAAAAAJAAAAAAAJ
JAAAAAAAAAAAAJAAAAAAAJ
OHHHHHHHHHHHHLAAAAAAAJ
J0000000000000AAAAAAAJ
JAAAAAAAAAAAAAAAAAAAAJ
JAAAAAAAAAAAAAAAAAAAAJ
JAAAAAAAAAAAAAAAAAAAAJ
KHHHHHHHHHHHHHHHHHHHHL
playerSpawnPosition 1 2
enemySpawnPosition 4 13