mapSize 22 15
tileSize 128 128
mapTiles
GHHHHHHNHHHHHHHHHHHHHIH
J000000Q0000000000000J
JAAAAAA0AAAAAAAAAAAAAJ
JAAAAAAAAAAAAAAAAAAAAJ
JAAAAAARAAAAAAAAAAAAAJ
JAAAAAAJAAAAAAAAAAAAAJ
OHHSATHPAAAAAAAAAAAAAJ
J000A00JAAAAAAAAAAAAAJ
JAAAAAAJAAAAAAAAAAAAAJ
JAAAAAAOHHHHHHHHHHHHHL
JAAAAAAJ00000000000000
JAAAAAAJ00000000000000
JAAAAAAJ00000000000000
JAAAAAAJ00000000000000
KHHHHHHL00000000000000

playerSpawnPosition 1 2
enemySpawnPosition 5 3