mapSize 50 50
tileSize 128 128
mapTiles
GHHHHHHHHHHHHHHHHHHHHNHHHHHHHHHHHHHHHHHHHHHHHHHHHI
J00000000000000000000J000000000000000000000000000J
JAAAAAAAAAAAAAAAAAAAAJAAAAAAAAAAAAAAAAAAAAAAAAAAAJ
JAAAAAAAAAAAAAAAAAAAAJAAAAAAAAAAAAAAAAAAAAAAAAAAAJ
JAAAAAAAAAAAAAAAAAAAAJAAAAAAAAAAAAAAAAAAAAAAAAAAAJ
JAAAAAAAAAAAAAAAAAAAAJAAAAAAAAAAAAAAAAAAAAAAAAAAAJ
OHHHHHHHHHHHHIAAAAAAAJAAAAAAAAAAAAAAAAAAAAAAAAAAAJ
J000000000000JAAAAAAAJAAAAAAAAAAAAAAAAAAAAAAAAAAAJ
JAAAAAAAAAAAAJAAAAAAAJAAAAAAAAAAAAAAAAAAAAAAAAAAAJ
JAAAAAAAAAAAAJAAAAAAAJAAAAAAAAAAAAAAAAAAAAAAAAAAAJ
JAAAAAAAAAAAAJAAAAAAAJAAAAAAAAAAAAAAAAAAAAAAAAAAAJ
JAAAAAAAAAAAAJAAAAAAAJAAAAAAAAAAAAAAAAAAAAAAAAAAAJ
JAAAAAAAAAAAAJAAAAAAAKHHHHHHHHHHHHHHHHHHHSAATHHHHP
JAAAAAAAAAAAAJAAAAAAA000000000000000000000AA00000J
OHHHHHHSATHHHLAAAAAAAAAAAAAAAAAAAAAAAAAAAAAAAAAAAJ
J0000000A00000AAAAAAAAAAAAAAAAAAAAAAAAAAAAAAAAAAAJ
JAAAAAAAAAAAAAAAAAAAAAAAAAAAAAAAAAAAAAAAAAAAAAAAAJ
JAAAAAAAAAAAAAAAAAAAAAAAAAAAAAAAAAAAAAAAAAAAAAAAAJ
JAAAAGHHHHHHHHHHHHHHHHHHHIAAAAAAAAAAAAAAAAAAAAAAAJ
JAAAAJ0000000000000000000JAAAAAAAAAAAAAAAAAAAAAAAJ
JAAAAJAAAAAAAAAAAAAAAAAAAJAAAAAAAAAAAAAAAAAAAAAAAJ
JAAAAJAAAAAAAAAAAAAAAAAAAJAAAAAAAAAAAAAAAAAAAAAAAJ
JAAAAJAAAAAAAAAAAAAAAAAAAJAAAAAAAAAAAAAAAAAAAAAAAJ
JAAAAJAAAAAAAAAAAAAAAAAAAJAAAAAAAAGHHHHHHHHHHHHHHP
JAAAAJAAAAAAAAAAAAAAAAAAAJAAAAAAAAJ00000000000000J
JAAAAJAAAAAAAAAAAAAAAAAAAJAAAAAAAAJAAAAAAAAAAAAAAJ
JAAAAJAAAAAAAAAAAAAAAAAAAJAAAAAAAAJAAAAAAAAAAAAAAJ
JAAAAKHHHHHHSAATHHHHHHHHHLAAAAAAAAJAAAAAAAAAAAAAAJ
JAAAA00000000AA00000000000AAAAAAAAQAAAAAAAAAAAAAAJ
JAAAAAAAAAAAAAAAAAAAAAAAAAAAAAAAAA0AAAAAAAAAAAAAAJ
JAAAAAAAAAAAAAAAAAAAAAAAAAAAAAAAAAAAAAAAAAAAAAAAAJ
JAAAAAAAAAAAAAAAAAAAAAAAAAAAAAAAAAAAAAAAAAAAAAAAAJ
JAAAAAAAAAAAAAAAAAAAAAAAAAAAAAAAAARAAAAAAAAAAAAAAJ
JAAAAAAAAAAAAAAAAAAAAAAAAAAAAAAAAAJAAAAAAAAAAAAAAJ
JAAAAAAAAAAAAAAAAAAAAAAAAAAAAAAAAAJAAAAAAAAAAAAAAJ
JAAAAATHHHHHHHHHHHHHHHHHHHHHHNHHHHMHHHHHHHHHHHHHHP
JAAAAA00000000000000000000000J0000000000000000000J
JAAAAAAAAAAAAAAAAAAAAAAAAAAAAJAAAAAAAAAAAAAAAAAAAJ
JAAAAAAAAAAAAAAAAAAAAAAAAAAAAJAAAAAAAAAAAAAAAAAAAJ
JAAAAAAAAAAAAAAAAAAAAAAAAAAAAJAAAAAAAAAAAAAAAAAAAJ
OHHHHHHHHHHHHHHHHHHHHHHSAAATHPAAAAAAAAAAAAAAAAAAAJ
J00000000000000000000000AAA00JAAAAAAAAAAAAAAAAAAAJ
JAAAAAAAAAAAAAAAAAAAAAAAAAAAAJAAAAAAAAAAAAAAAAAAAJ
JAAAAAAAAAAAAAAAAAAAAAAAAAAAAQAAAAAAAAAAAAAAAAAAAJ
JAAAAAAAAAAAAAAAAAAAAAAAAAAAA0AAAAAAAAAAAAAAAAAAAJ
JAAAAAAAAAAAAAAAAAAAAAAAAAAAAAAAAAAAAAAAAAAAAAAAAJ
JAAAAAAAAAAAAAAAAAAAAAAAAAAAAAAAAAAAAAAAAAAAAAAAAJ
JAAAAAAAAAAAAAAAAAAAAAAAAAAAARAAAAAAAAAAAAAAAAAAAJ
JAAAAAAAAAAAAAAAAAAAAAAAAAAAAJAAAAAAAAAAAAAAAAAAAJ
KHHHHHHHHHHHHHHHHHHHHHHHHHHHHMHHHHHHHHHHHHHHHHHHHL
playerSpawnPosition 1 2
enemySpawnPosition 7 3